..............................
..............................
..............................
..............................
..............................
..............................
..............................
""""""".......................
..............................
..............................
............"""...............
............#.................
........""""#.................
........#.....................
........#.....................
""""""""#"""""""""""""""""""""
##############################
