..............................
..............................
..............................
..............................
..............................
..""""".................""""..
........""..........."".......
..........."".....""..........
..............".".............
..............................
..............".".............
..........."".....""..........
........""..........."".......
..""""".................""""..
..............................
""""""""""""""""""""""""""""""
##############################
