......................................................
......................................................
......................................................
......................................................
......................................................
......................................................
......................................................
......................................................
......................................................
......................................................
......................................................
""""""".......................................""""""""
......................................................
......................................................
............"""........................."""...........
............#.............................#...........
........""""#.............................#"""........
........#....................................#........
........#....................................#........
""""""""#""""""""""""""""""""""""""""""""""""#""""""""
######################################################
######################################################
######################################################
######################################################
######################################################
