......................................................
......................................................
..."""""......................................"""""...
......................................................
............"""""...................."""""............
......................................................
....................."""""..""""".....................
......................................................
......................................................
......................................................
....................."""""..""""".....................
......................................................
......................................................
............"""""...................."""""............
......................................................
......................................................
..."""""......................................"""""...
......................................................
......................................................
""""""""""""""""""""""""""""""""""""""""""""""""""""""
######################################################
######################################################
######################################################
######################################################
######################################################
