..............................
..............................
............................x.
.....................##....##.
.........x....................
.........##....##.............
..............................
...........##.....##..........
..........................x...
............##........#...#...
....#...x.....................
......""""....................
#.....#......................#
#"""""#.....#.................
##..........#.................
##.......#####............."..
######"""#####################
