..............................
..............................
..............................
..............................
..............................
..............................
..............................
..............................
..............................
..............................
..............................
..............................
..............................
..............................
....x....................x....
""""""""""""""""""""""""""""""
##############################
