..............................
..............................
..............................
..............................
..............................
..............................
..x...........................
""""""".......................
..............................
.............x................
............"""...............
............#.................
........""""#.................
........#.....................
..x.....#.................x...
""""""""#"""""""""""""""""""""
##############################
