..............................
..............................
.........##....##.............
..............................
...........##.....##..........
..............................
............##........#...#...
....#.........................
......""""....................
#.....#......................#
#"""""#.....#.................
##..........#.................
##.......#####............."..
.........##....##.............
..............................
....x......##.....##.....x....
######"""#####################
