.....................##....##.
..............................
....x....##....##.......x...x.
......x...............x...x...
.......x...##.....##..........
........x.....................
............##........#...#...
....#.........................
......"""".................x..
#x....#......................#
#"""""#.....#.....x...........
##xxxx......#.................
##xxxx...#####............."..
....x....##....##.......x...x.
......x...............x...x...
.......x...##.....##..........
######"""#####################
